5
5 9
0 -1 0 0 -1 0 0 0 0 
-1 0 0 0 0 -1 -1 0 0 
0 0 0 -1 -1 0 0 0 0 
-1 0 -1 0 0 0 0 0 -1 
-1 0 0 0 0 0 -1 -1 0 
8 6
0 0 -1 0 0 0 
-1 0 0 0 -1 0 
0 0 0 0 0 0 
0 -1 0 0 0 0 
-1 -1 0 -1 -1 0 
0 0 -1 -1 0 0 
0 0 0 -1 0 0 
0 0 -1 0 -1 0 
14 12
0 0 0 0 0 0 0 0 -1 0 -1 0 
0 0 -1 0 0 0 0 -1 -1 0 0 0 
0 -1 -1 0 0 -1 0 -1 0 0 0 -1 
-1 0 -1 0 0 -1 0 0 -1 0 -1 -1 
0 -1 0 0 0 0 0 0 -1 0 0 0 
-1 -1 0 0 0 0 -1 -1 -1 -1 0 0 
0 0 0 -1 -1 0 0 -1 0 0 0 0 
0 -1 -1 -1 0 0 0 -1 0 0 0 -1 
-1 0 0 -1 -1 -1 0 0 0 0 0 0 
0 0 -1 0 0 -1 -1 0 0 -1 -1 -1 
-1 0 0 -1 0 0 0 -1 0 0 0 0 
-1 0 0 0 0 -1 -1 0 -1 0 0 0 
0 0 0 -1 0 0 -1 0 0 0 0 0 
0 0 0 0 -1 0 0 0 0 0 0 0 
15 12
0 0 -1 0 0 -1 -1 0 -1 -1 0 0 
0 0 -1 0 0 -1 0 0 0 0 0 0 
-1 -1 -1 -1 0 0 0 0 0 0 0 0 
-1 -1 0 0 -1 0 0 0 0 -1 0 0 
0 -1 -1 -1 -1 0 0 0 0 -1 0 0 
0 0 0 -1 0 0 -1 0 -1 -1 0 0 
0 0 0 0 -1 0 0 0 -1 0 -1 -1 
-1 0 -1 -1 0 0 -1 0 -1 -1 0 0 
0 0 0 0 -1 0 0 0 -1 -1 0 0 
-1 0 -1 0 -1 -1 0 0 0 0 -1 0 
0 0 -1 0 -1 0 -1 0 0 0 0 0 
0 -1 -1 0 -1 -1 0 -1 0 0 0 -1 
0 0 0 -1 0 0 0 -1 0 -1 0 -1 
0 0 -1 -1 0 -1 0 -1 0 -1 -1 -1 
0 0 0 -1 -1 -1 0 -1 0 -1 0 0 
4 14
0 0 0 0 -1 0 0 -1 -1 -1 -1 0 0 -1 
0 0 0 -1 -1 -1 0 0 0 0 0 0 -1 -1 
0 0 0 0 0 0 0 -1 0 0 -1 -1 0 0 
0 0 0 0 0 -1 0 0 0 0 -1 -1 0 0 